[Header]
Name : dede
Tile Size : 16
Height : 3
X : 30
Y : 30
Texture File : data/imgs/tileset.png
[/Header]

[Tileset]
| 0/0/0/0/0/0/0/0/0/0/0/0/0/0/0/0/0/0/0/0/0/0/0/0/0/0/0/0/0/0/0/0/0/0/0/0/0/0/0/0/0/0/0/0/0/0/0/0/0/0/0/0/0/0/0/0/0/0/0/0/0/0/0/0/0/0/0/0/0/0/0/0/0/0/0/0/0/0/0/0/0/0/0/0/0/0/0/0/0/0/0/0/0/0/0/0/0/0/0/0/0/0/0/0/0/0/0/0/0/0/0/0/0/0/0/0/0/0/0/0/0/0/0/0/0/0/0/0/0/0/0/0/0/0/0/0/0/0/0/0/0/0/0/0/0/0/0/0/0/0/0/0/0/0/0/0/0/0/0/0/0/0/0/0/0/0/0/0/0/0/0/0/0/0/0/0/0/0/0/0/0/0/0/0/0/0/0/0/0/0/0/0/0/0/0/0/0/0/0/0/0/0/0/0/0/0/0/0/0/0/0/0/0/0/0/0/0/0/0/0/0/0/0/0/0/0/0/0/0/0/0/0/0/0/0/0/0/0/0/0/0/0/0/0/0/0/0/0/0/0/0/0/0/0/0/0/0/0/0/0/0/0/0/0/0/0/0/0/0/0/0/0/0/0/0/0/0/0/0/0/0/0/0/0/0/0/0/0/0/0/0/0/0/0/0/0/0/0/0/0/0/0/0/0/0/0/0/0/0/0/0/0/0/0/0/0/0/0/0/0/0/0/0/0/0/0/0/0/0/0/0/0/0/0/0/0/0/0/0/0/0/0/0/0/0/0/0/0/0/0/0/0/0/0/0/0/0/0/0/0/0/0/0/0/0/0/0/0/0/0/0/0/0/0/0/0/0/0/0/0/0/0/0/0/0/0/0/0/0/0/0/0/0/0/0/0/0/0/0/0/0/0/0/0/0/0/0/0/0/0/0/0/0/0/0/0/0/0/0/0/0/0/0/0/0/0/0/0/0/0/0/0/0/0/0/0/0/0/0/0/0/0/0/0/0/0/0/0/0/0/0/0/0/0/0/0/0/0/0/0/0/0/0/0/0/0/0/0/0/0/0/0/0/0/0/0/0/0/0/0/0/0/0/0/0/0/0/0/0/0/0/0/0/0/0/0/0/0/0/0/0/0/0/0/0/0/0/0/0/0/0/0/0/0/0/0/0/0/0/0/0/0/0/0/0/0/0/0/0/0/0/0/0/0/0/0/0/0/0/0/0/0/0/0/0/0/0/0/0/0/0/0/0/0/0/0/0/0/0/0/0/0/0/0/0/0/0/0/0/0/0/0/0/0/0/0 |
[/Tileset]

[Map]
[H0]
| (0,0-0) (0,0-0) (0,0-0) (0,0-0) (0,0-0) (0,0-0) (0,0-0) (0,0-0) (0,0-0) (0,0-0) (0,0-0) (0,0-0) (0,0-0) (0,0-0) (0,0-0) (0,0-0) (0,0-0) (0,0-0) (0,0-0) (0,0-0) (0,0-0) (0,0-0) (0,0-0) (0,0-0) (0,0-0) (0,0-0) (0,0-0) (0,0-0) (0,0-0) (0,0-0) |
| (0,0-0) (0,0-0) (0,0-0) (0,0-0) (0,0-0) (0,0-0) (0,0-0) (0,0-0) (0,0-0) (0,0-0) (0,0-0) (0,0-0) (0,0-0) (0,0-0) (0,0-0) (0,0-0) (0,0-0) (0,0-0) (0,0-0) (0,0-0) (0,0-0) (0,0-0) (0,0-0) (0,0-0) (0,0-0) (0,0-0) (0,0-0) (0,0-0) (0,0-0) (0,0-0) |
| (0,0-0) (0,0-0) (0,0-0) (0,0-0) (0,0-0) (0,0-0) (0,0-0) (0,0-0) (0,0-0) (0,0-0) (0,0-0) (0,0-0) (0,0-0) (0,0-0) (0,0-0) (0,0-0) (0,0-0) (0,0-0) (0,0-0) (0,0-0) (0,0-0) (0,0-0) (0,0-0) (0,0-0) (0,0-0) (0,0-0) (0,0-0) (0,0-0) (0,0-0) (0,0-0) |
| (0,0-0) (0,0-0) (0,0-0) (0,0-0) (0,0-0) (0,0-0) (0,0-0) (0,0-0) (0,0-0) (0,0-0) (0,0-0) (0,0-0) (0,0-0) (0,0-0) (0,0-0) (0,0-0) (0,0-0) (0,0-0) (0,0-0) (0,0-0) (0,0-0) (0,0-0) (0,0-0) (0,0-0) (0,0-0) (0,0-0) (0,0-0) (0,0-0) (0,0-0) (0,0-0) |
| (0,0-0) (0,0-0) (0,0-0) (0,0-0) (0,0-0) (0,0-0) (0,0-0) (0,0-0) (0,0-0) (0,0-0) (0,0-0) (0,0-0) (0,0-0) (0,0-0) (0,0-0) (0,0-0) (0,0-0) (0,0-0) (0,0-0) (0,0-0) (0,0-0) (0,0-0) (0,0-0) (0,0-0) (0,0-0) (0,0-0) (0,0-0) (0,0-0) (0,0-0) (0,0-0) |
| (0,0-0) (0,0-0) (0,0-0) (0,0-0) (0,0-0) (0,0-0) (0,0-0) (0,0-0) (0,0-0) (0,0-0) (0,0-0) (0,0-0) (0,0-0) (0,0-0) (0,0-0) (0,0-0) (0,0-0) (0,0-0) (0,0-0) (0,0-0) (0,0-0) (0,0-0) (0,0-0) (0,0-0) (0,0-0) (0,0-0) (0,0-0) (0,0-0) (0,0-0) (0,0-0) |
| (0,0-0) (0,0-0) (0,0-0) (0,0-0) (0,0-0) (0,0-0) (0,0-0) (0,0-0) (0,0-0) (0,0-0) (0,0-0) (0,0-0) (0,0-0) (0,0-0) (0,0-0) (0,0-0) (0,0-0) (0,0-0) (0,0-0) (0,0-0) (0,0-0) (0,0-0) (0,0-0) (0,0-0) (0,0-0) (0,0-0) (0,0-0) (0,0-0) (0,0-0) (0,0-0) |
| (0,0-0) (0,0-0) (0,0-0) (0,0-0) (0,0-0) (0,0-0) (0,0-0) (0,0-0) (0,0-0) (0,0-0) (0,0-0) (0,0-0) (2,1-0) (0,0-0) (0,0-0) (0,0-0) (0,0-0) (0,0-0) (0,0-0) (0,0-0) (0,0-0) (0,0-0) (0,0-0) (0,0-0) (0,0-0) (0,0-0) (0,0-0) (0,0-0) (0,0-0) (0,0-0) |
| (0,0-0) (0,0-0) (0,0-0) (0,0-0) (0,0-0) (0,0-0) (0,0-0) (0,0-0) (0,0-0) (0,0-0) (0,0-0) (2,1-0) (0,0-0) (2,1-0) (0,0-0) (0,0-0) (0,0-0) (0,0-0) (0,0-0) (0,0-0) (0,0-0) (0,0-0) (0,0-0) (0,0-0) (0,0-0) (0,0-0) (0,0-0) (0,0-0) (0,0-0) (0,0-0) |
| (0,0-0) (0,0-0) (0,0-0) (0,0-0) (0,0-0) (0,0-0) (0,0-0) (0,0-0) (0,0-0) (0,0-0) (2,1-0) (2,1-0) (0,0-0) (2,1-0) (0,0-0) (2,1-0) (0,0-0) (0,0-0) (0,0-0) (0,0-0) (0,0-0) (0,0-0) (0,0-0) (0,0-0) (0,0-0) (0,0-0) (0,0-0) (0,0-0) (0,0-0) (0,0-0) |
| (0,0-0) (0,0-0) (0,0-0) (0,0-0) (0,0-0) (0,0-0) (0,0-0) (0,0-0) (0,0-0) (2,1-0) (2,1-0) (0,0-0) (0,0-0) (0,0-0) (2,1-0) (0,0-0) (0,0-0) (0,0-0) (0,0-0) (0,0-0) (0,0-0) (0,0-0) (0,0-0) (0,0-0) (0,0-0) (0,0-0) (0,0-0) (0,0-0) (0,0-0) (0,0-0) |
| (0,0-0) (0,0-0) (0,0-0) (0,0-0) (0,0-0) (0,0-0) (0,0-0) (0,0-0) (0,0-0) (2,1-0) (0,0-0) (0,0-0) (0,0-0) (0,0-0) (0,0-0) (2,1-0) (2,1-0) (0,0-0) (0,0-0) (0,0-0) (0,0-0) (0,0-0) (0,0-0) (0,0-0) (0,0-0) (0,0-0) (0,0-0) (0,0-0) (0,0-0) (0,0-0) |
| (0,0-0) (0,0-0) (0,0-0) (0,0-0) (0,0-0) (0,0-0) (0,0-0) (0,0-0) (0,0-0) (2,1-0) (0,0-0) (0,0-0) (0,0-0) (0,0-0) (0,0-0) (0,0-0) (0,0-0) (0,0-0) (0,0-0) (0,0-0) (0,0-0) (0,0-0) (0,0-0) (0,0-0) (0,0-0) (0,0-0) (0,0-0) (0,0-0) (0,0-0) (0,0-0) |
| (0,0-0) (0,0-0) (0,0-0) (0,0-0) (0,0-0) (0,0-0) (0,0-0) (2,1-0) (0,0-0) (0,0-0) (0,0-0) (0,0-0) (0,0-0) (0,0-0) (0,0-0) (0,0-0) (0,0-0) (2,1-0) (0,0-0) (0,0-0) (0,0-0) (0,0-0) (0,0-0) (0,0-0) (0,0-0) (0,0-0) (0,0-0) (0,0-0) (0,0-0) (0,0-0) |
| (0,0-0) (0,0-0) (0,0-0) (0,0-0) (0,0-0) (0,0-0) (2,1-0) (0,0-0) (0,0-0) (0,0-0) (0,0-0) (0,0-0) (0,0-0) (2,1-0) (0,0-0) (2,1-0) (0,0-0) (2,1-0) (0,0-0) (0,0-0) (0,0-0) (0,0-0) (0,0-0) (0,0-0) (0,0-0) (0,0-0) (0,0-0) (0,0-0) (0,0-0) (0,0-0) |
| (0,0-0) (0,0-0) (0,0-0) (0,0-0) (0,0-0) (0,0-0) (2,1-0) (0,0-0) (0,0-0) (0,0-0) (2,1-0) (2,1-0) (0,0-0) (0,0-0) (0,0-0) (0,0-0) (0,0-0) (2,1-0) (0,0-0) (0,0-0) (0,0-0) (0,0-0) (0,0-0) (0,0-0) (0,0-0) (0,0-0) (0,0-0) (0,0-0) (0,0-0) (0,0-0) |
| (0,0-0) (0,0-0) (0,0-0) (0,0-0) (0,0-0) (0,0-0) (2,1-0) (0,0-0) (0,0-0) (0,0-0) (0,0-0) (0,0-0) (0,0-0) (0,0-0) (2,1-0) (0,0-0) (0,0-0) (2,1-0) (0,0-0) (0,0-0) (0,0-0) (0,0-0) (0,0-0) (0,0-0) (0,0-0) (0,0-0) (0,0-0) (0,0-0) (0,0-0) (0,0-0) |
| (0,0-0) (0,0-0) (0,0-0) (0,0-0) (0,0-0) (0,0-0) (0,0-0) (2,1-0) (0,0-0) (0,0-0) (2,1-0) (2,1-0) (0,0-0) (0,0-0) (2,1-0) (0,0-0) (0,0-0) (2,1-0) (0,0-0) (0,0-0) (0,0-0) (0,0-0) (0,0-0) (0,0-0) (0,0-0) (0,0-0) (0,0-0) (0,0-0) (0,0-0) (0,0-0) |
| (0,0-0) (0,0-0) (0,0-0) (0,0-0) (0,0-0) (0,0-0) (0,0-0) (0,0-0) (2,1-0) (0,0-0) (2,1-0) (0,0-0) (2,1-0) (2,1-0) (2,1-0) (0,0-0) (0,0-0) (2,1-0) (0,0-0) (0,0-0) (0,0-0) (0,0-0) (0,0-0) (0,0-0) (0,0-0) (0,0-0) (0,0-0) (0,0-0) (0,0-0) (0,0-0) |
| (0,0-0) (0,0-0) (0,0-0) (0,0-0) (0,0-0) (0,0-0) (0,0-0) (0,0-0) (0,0-0) (0,0-0) (2,1-0) (2,1-0) (2,1-0) (0,0-0) (0,0-0) (2,1-0) (2,1-0) (0,0-0) (0,0-0) (0,0-0) (0,0-0) (0,0-0) (0,0-0) (0,0-0) (0,0-0) (0,0-0) (0,0-0) (0,0-0) (0,0-0) (0,0-0) |
| (0,0-0) (0,0-0) (0,0-0) (0,0-0) (0,0-0) (0,0-0) (0,0-0) (0,0-0) (0,0-0) (0,0-0) (0,0-0) (0,0-0) (0,0-0) (0,0-0) (0,0-0) (0,0-0) (0,0-0) (0,0-0) (0,0-0) (0,0-0) (0,0-0) (0,0-0) (0,0-0) (0,0-0) (0,0-0) (0,0-0) (0,0-0) (0,0-0) (0,0-0) (0,0-0) |
| (0,0-0) (0,0-0) (0,0-0) (0,0-0) (0,0-0) (0,0-0) (0,0-0) (0,0-0) (0,0-0) (0,0-0) (0,0-0) (0,0-0) (0,0-0) (0,0-0) (0,0-0) (0,0-0) (0,0-0) (0,0-0) (0,0-0) (0,0-0) (0,0-0) (0,0-0) (0,0-0) (0,0-0) (0,0-0) (0,0-0) (0,0-0) (0,0-0) (0,0-0) (0,0-0) |
| (0,0-0) (0,0-0) (0,0-0) (0,0-0) (0,0-0) (0,0-0) (0,0-0) (0,0-0) (0,0-0) (0,0-0) (0,0-0) (0,0-0) (0,0-0) (0,0-0) (0,0-0) (0,0-0) (0,0-0) (0,0-0) (0,0-0) (0,0-0) (0,0-0) (0,0-0) (0,0-0) (0,0-0) (0,0-0) (0,0-0) (0,0-0) (0,0-0) (0,0-0) (0,0-0) |
| (0,0-0) (0,0-0) (0,0-0) (0,0-0) (0,0-0) (0,0-0) (0,0-0) (0,0-0) (0,0-0) (0,0-0) (0,0-0) (0,0-0) (0,0-0) (0,0-0) (0,0-0) (0,0-0) (0,0-0) (0,0-0) (0,0-0) (0,0-0) (0,0-0) (0,0-0) (0,0-0) (0,0-0) (0,0-0) (0,0-0) (0,0-0) (0,0-0) (0,0-0) (0,0-0) |
| (0,0-0) (0,0-0) (0,0-0) (0,0-0) (0,0-0) (0,0-0) (0,0-0) (0,0-0) (0,0-0) (0,0-0) (0,0-0) (0,0-0) (0,0-0) (0,0-0) (0,0-0) (0,0-0) (0,0-0) (0,0-0) (0,0-0) (0,0-0) (0,0-0) (0,0-0) (0,0-0) (0,0-0) (0,0-0) (0,0-0) (0,0-0) (0,0-0) (0,0-0) (0,0-0) |
| (0,0-0) (0,0-0) (0,0-0) (0,0-0) (0,0-0) (0,0-0) (0,0-0) (0,0-0) (0,0-0) (0,0-0) (0,0-0) (0,0-0) (0,0-0) (0,0-0) (0,0-0) (0,0-0) (0,0-0) (0,0-0) (0,0-0) (0,0-0) (0,0-0) (0,0-0) (0,0-0) (0,0-0) (0,0-0) (0,0-0) (0,0-0) (0,0-0) (0,0-0) (0,0-0) |
| (0,0-0) (0,0-0) (0,0-0) (0,0-0) (0,0-0) (0,0-0) (0,0-0) (0,0-0) (0,0-0) (0,0-0) (0,0-0) (0,0-0) (0,0-0) (0,0-0) (0,0-0) (0,0-0) (0,0-0) (0,0-0) (0,0-0) (0,0-0) (0,0-0) (0,0-0) (0,0-0) (0,0-0) (0,0-0) (0,0-0) (0,0-0) (0,0-0) (0,0-0) (0,0-0) |
| (0,0-0) (0,0-0) (0,0-0) (0,0-0) (0,0-0) (0,0-0) (0,0-0) (0,0-0) (0,0-0) (0,0-0) (0,0-0) (0,0-0) (0,0-0) (0,0-0) (0,0-0) (0,0-0) (0,0-0) (0,0-0) (0,0-0) (0,0-0) (0,0-0) (0,0-0) (0,0-0) (0,0-0) (0,0-0) (0,0-0) (0,0-0) (0,0-0) (0,0-0) (0,0-0) |
| (0,0-0) (0,0-0) (0,0-0) (0,0-0) (0,0-0) (0,0-0) (0,0-0) (0,0-0) (0,0-0) (0,0-0) (0,0-0) (0,0-0) (0,0-0) (0,0-0) (0,0-0) (0,0-0) (0,0-0) (0,0-0) (0,0-0) (0,0-0) (0,0-0) (0,0-0) (0,0-0) (0,0-0) (0,0-0) (0,0-0) (0,0-0) (0,0-0) (0,0-0) (0,0-0) |
| (0,0-0) (0,0-0) (0,0-0) (0,0-0) (0,0-0) (0,0-0) (0,0-0) (0,0-0) (0,0-0) (0,0-0) (0,0-0) (0,0-0) (0,0-0) (0,0-0) (0,0-0) (0,0-0) (0,0-0) (0,0-0) (0,0-0) (0,0-0) (0,0-0) (0,0-0) (0,0-0) (0,0-0) (0,0-0) (0,0-0) (0,0-0) (0,0-0) (0,0-0) (0,0-0) |
[/H0]
[H1]
| (0,0-0) (0,0-0) (0,0-0) (0,0-0) (0,0-0) (0,0-0) (0,0-0) (0,0-0) (0,0-0) (0,0-0) (0,0-0) (0,0-0) (0,0-0) (0,0-0) (0,0-0) (0,0-0) (0,0-0) (0,0-0) (0,0-0) (0,0-0) (0,0-0) (0,0-0) (0,0-0) (0,0-0) (0,0-0) (0,0-0) (0,0-0) (0,0-0) (0,0-0) (0,0-0) |
| (0,0-0) (0,0-0) (0,0-0) (0,0-0) (0,0-0) (0,0-0) (0,0-0) (0,0-0) (0,0-0) (0,0-0) (0,0-0) (0,0-0) (0,0-0) (0,0-0) (0,0-0) (0,0-0) (0,0-0) (0,0-0) (0,0-0) (0,0-0) (0,0-0) (0,0-0) (0,0-0) (0,0-0) (0,0-0) (0,0-0) (0,0-0) (0,0-0) (0,0-0) (0,0-0) |
| (0,0-0) (0,0-0) (0,0-0) (0,0-0) (0,0-0) (0,0-0) (0,0-0) (0,0-0) (0,0-0) (0,0-0) (0,0-0) (0,0-0) (0,0-0) (0,0-0) (0,0-0) (0,0-0) (0,0-0) (0,0-0) (0,0-0) (0,0-0) (0,0-0) (0,0-0) (0,0-0) (0,0-0) (0,0-0) (0,0-0) (0,0-0) (0,0-0) (0,0-0) (0,0-0) |
| (0,0-0) (0,0-0) (0,0-0) (0,0-0) (0,0-0) (0,0-0) (0,0-0) (0,0-0) (0,0-0) (0,0-0) (0,0-0) (0,0-0) (0,0-0) (0,0-0) (0,0-0) (0,0-0) (0,0-0) (0,0-0) (0,0-0) (0,0-0) (0,0-0) (0,0-0) (0,0-0) (0,0-0) (0,0-0) (0,0-0) (0,0-0) (0,0-0) (0,0-0) (0,0-0) |
| (0,0-0) (0,0-0) (0,0-0) (0,0-0) (0,0-0) (0,0-0) (0,0-0) (0,0-0) (0,0-0) (0,0-0) (0,0-0) (0,0-0) (0,0-0) (0,0-0) (0,0-0) (0,0-0) (0,0-0) (0,0-0) (0,0-0) (0,0-0) (0,0-0) (0,0-0) (0,0-0) (0,0-0) (0,0-0) (0,0-0) (0,0-0) (0,0-0) (0,0-0) (0,0-0) |
| (0,0-0) (0,0-0) (0,0-0) (0,0-0) (0,0-0) (0,0-0) (0,0-0) (0,0-0) (0,0-0) (0,0-0) (0,0-0) (0,0-0) (0,0-0) (0,0-0) (0,0-0) (0,0-0) (0,0-0) (0,0-0) (0,0-0) (0,0-0) (0,0-0) (0,0-0) (0,0-0) (0,0-0) (0,0-0) (0,0-0) (0,0-0) (0,0-0) (0,0-0) (0,0-0) |
| (0,0-0) (0,0-0) (0,0-0) (0,0-0) (0,0-0) (0,0-0) (0,0-0) (0,0-0) (0,0-0) (0,0-0) (0,0-0) (0,0-0) (0,0-0) (0,0-0) (0,0-0) (0,0-0) (0,0-0) (0,0-0) (0,0-0) (0,0-0) (0,0-0) (0,0-0) (0,0-0) (0,0-0) (0,0-0) (0,0-0) (0,0-0) (0,0-0) (0,0-0) (0,0-0) |
| (0,0-0) (0,0-0) (0,0-0) (0,0-0) (0,0-0) (0,0-0) (0,0-0) (0,0-0) (0,0-0) (0,0-0) (0,0-0) (0,0-0) (0,0-0) (0,0-0) (0,0-0) (0,0-0) (0,0-0) (0,0-0) (0,0-0) (0,0-0) (0,0-0) (0,0-0) (0,0-0) (0,0-0) (0,0-0) (0,0-0) (0,0-0) (0,0-0) (0,0-0) (0,0-0) |
| (0,0-0) (0,0-0) (0,0-0) (0,0-0) (0,0-0) (0,0-0) (0,0-0) (0,0-0) (0,0-0) (0,0-0) (0,0-0) (0,0-0) (0,0-0) (0,0-0) (0,0-0) (0,0-0) (0,0-0) (0,0-0) (0,0-0) (0,0-0) (0,0-0) (0,0-0) (0,0-0) (0,0-0) (0,0-0) (0,0-0) (0,0-0) (0,0-0) (0,0-0) (0,0-0) |
| (0,0-0) (0,0-0) (0,0-0) (0,0-0) (0,0-0) (0,0-0) (0,0-0) (0,0-0) (0,0-0) (0,0-0) (0,0-0) (0,0-0) (0,0-0) (0,0-0) (0,0-0) (0,0-0) (0,0-0) (0,0-0) (0,0-0) (0,0-0) (0,0-0) (0,0-0) (0,0-0) (0,0-0) (0,0-0) (0,0-0) (0,0-0) (0,0-0) (0,0-0) (0,0-0) |
| (0,0-0) (0,0-0) (0,0-0) (0,0-0) (0,0-0) (0,0-0) (0,0-0) (0,0-0) (0,0-0) (0,0-0) (0,0-0) (0,0-0) (0,0-0) (0,0-0) (0,0-0) (0,0-0) (0,0-0) (0,0-0) (0,0-0) (0,0-0) (0,0-0) (0,0-0) (0,0-0) (0,0-0) (0,0-0) (0,0-0) (0,0-0) (0,0-0) (0,0-0) (0,0-0) |
| (0,0-0) (0,0-0) (0,0-0) (0,0-0) (0,0-0) (0,0-0) (0,0-0) (0,0-0) (0,0-0) (0,0-0) (0,0-0) (0,0-0) (0,0-0) (0,0-0) (0,0-0) (0,0-0) (0,0-0) (0,0-0) (0,0-0) (0,0-0) (0,0-0) (0,0-0) (0,0-0) (0,0-0) (0,0-0) (0,0-0) (0,0-0) (0,0-0) (0,0-0) (0,0-0) |
| (0,0-0) (0,0-0) (0,0-0) (0,0-0) (0,0-0) (0,0-0) (0,0-0) (0,0-0) (0,0-0) (0,0-0) (0,0-0) (0,0-0) (0,0-0) (0,0-0) (0,0-0) (0,0-0) (0,0-0) (0,0-0) (0,0-0) (0,0-0) (0,0-0) (0,0-0) (0,0-0) (0,0-0) (0,0-0) (0,0-0) (0,0-0) (0,0-0) (0,0-0) (0,0-0) |
| (0,0-0) (0,0-0) (0,0-0) (0,0-0) (0,0-0) (0,0-0) (0,0-0) (0,0-0) (0,0-0) (0,0-0) (0,0-0) (0,0-0) (0,0-0) (0,0-0) (0,0-0) (0,0-0) (0,0-0) (0,0-0) (0,0-0) (0,0-0) (0,0-0) (0,0-0) (0,0-0) (0,0-0) (0,0-0) (0,0-0) (0,0-0) (0,0-0) (0,0-0) (0,0-0) |
| (0,0-0) (0,0-0) (0,0-0) (0,0-0) (0,0-0) (0,0-0) (0,0-0) (0,0-0) (0,0-0) (0,0-0) (0,0-0) (0,0-0) (0,0-0) (0,0-0) (0,0-0) (0,0-0) (0,0-0) (0,0-0) (0,0-0) (0,0-0) (0,0-0) (0,0-0) (0,0-0) (0,0-0) (0,0-0) (0,0-0) (0,0-0) (0,0-0) (0,0-0) (0,0-0) |
| (0,0-0) (0,0-0) (0,0-0) (0,0-0) (0,0-0) (0,0-0) (0,0-0) (0,0-0) (0,0-0) (0,0-0) (0,0-0) (0,0-0) (0,0-0) (0,0-0) (0,0-0) (0,0-0) (0,0-0) (0,0-0) (0,0-0) (0,0-0) (0,0-0) (0,0-0) (0,0-0) (0,0-0) (0,0-0) (0,0-0) (0,0-0) (0,0-0) (0,0-0) (0,0-0) |
| (0,0-0) (0,0-0) (0,0-0) (0,0-0) (0,0-0) (0,0-0) (0,0-0) (0,0-0) (0,0-0) (0,0-0) (0,0-0) (0,0-0) (0,0-0) (0,0-0) (0,0-0) (0,0-0) (0,0-0) (0,0-0) (0,0-0) (0,0-0) (0,0-0) (0,0-0) (0,0-0) (0,0-0) (0,0-0) (0,0-0) (0,0-0) (0,0-0) (0,0-0) (0,0-0) |
| (0,0-0) (0,0-0) (0,0-0) (0,0-0) (0,0-0) (0,0-0) (0,0-0) (0,0-0) (0,0-0) (0,0-0) (0,0-0) (0,0-0) (0,0-0) (0,0-0) (0,0-0) (0,0-0) (0,0-0) (0,0-0) (0,0-0) (0,0-0) (0,0-0) (0,0-0) (0,0-0) (0,0-0) (0,0-0) (0,0-0) (0,0-0) (0,0-0) (0,0-0) (0,0-0) |
| (0,0-0) (0,0-0) (0,0-0) (0,0-0) (0,0-0) (0,0-0) (0,0-0) (0,0-0) (0,0-0) (0,0-0) (0,0-0) (0,0-0) (0,0-0) (0,0-0) (0,0-0) (0,0-0) (0,0-0) (0,0-0) (0,0-0) (0,0-0) (0,0-0) (0,0-0) (0,0-0) (0,0-0) (0,0-0) (0,0-0) (0,0-0) (0,0-0) (0,0-0) (0,0-0) |
| (0,0-0) (0,0-0) (0,0-0) (0,0-0) (0,0-0) (0,0-0) (0,0-0) (0,0-0) (0,0-0) (0,0-0) (0,0-0) (0,0-0) (0,0-0) (0,0-0) (0,0-0) (0,0-0) (0,0-0) (0,0-0) (0,0-0) (0,0-0) (0,0-0) (0,0-0) (0,0-0) (0,0-0) (0,0-0) (0,0-0) (0,0-0) (0,0-0) (0,0-0) (0,0-0) |
| (0,0-0) (0,0-0) (0,0-0) (0,0-0) (0,0-0) (0,0-0) (0,0-0) (0,0-0) (0,0-0) (0,0-0) (0,0-0) (0,0-0) (0,0-0) (0,0-0) (0,0-0) (0,0-0) (0,0-0) (0,0-0) (0,0-0) (0,0-0) (0,0-0) (0,0-0) (0,0-0) (0,0-0) (0,0-0) (0,0-0) (0,0-0) (0,0-0) (0,0-0) (0,0-0) |
| (0,0-0) (0,0-0) (0,0-0) (0,0-0) (0,0-0) (0,0-0) (0,0-0) (0,0-0) (0,0-0) (0,0-0) (0,0-0) (0,0-0) (0,0-0) (0,0-0) (0,0-0) (0,0-0) (0,0-0) (0,0-0) (0,0-0) (0,0-0) (0,0-0) (0,0-0) (0,0-0) (0,0-0) (0,0-0) (0,0-0) (0,0-0) (0,0-0) (0,0-0) (0,0-0) |
| (0,0-0) (0,0-0) (0,0-0) (0,0-0) (0,0-0) (0,0-0) (0,0-0) (0,0-0) (0,0-0) (0,0-0) (0,0-0) (0,0-0) (0,0-0) (0,0-0) (0,0-0) (0,0-0) (0,0-0) (0,0-0) (0,0-0) (0,0-0) (0,0-0) (0,0-0) (0,0-0) (0,0-0) (0,0-0) (0,0-0) (0,0-0) (0,0-0) (0,0-0) (0,0-0) |
| (0,0-0) (0,0-0) (0,0-0) (0,0-0) (0,0-0) (0,0-0) (0,0-0) (0,0-0) (0,0-0) (0,0-0) (0,0-0) (0,0-0) (0,0-0) (0,0-0) (0,0-0) (0,0-0) (0,0-0) (0,0-0) (0,0-0) (0,0-0) (0,0-0) (0,0-0) (0,0-0) (0,0-0) (0,0-0) (0,0-0) (0,0-0) (0,0-0) (0,0-0) (0,0-0) |
| (0,0-0) (0,0-0) (0,0-0) (0,0-0) (0,0-0) (0,0-0) (0,0-0) (0,0-0) (0,0-0) (0,0-0) (0,0-0) (0,0-0) (0,0-0) (0,0-0) (0,0-0) (0,0-0) (0,0-0) (0,0-0) (0,0-0) (0,0-0) (0,0-0) (0,0-0) (0,0-0) (0,0-0) (0,0-0) (0,0-0) (0,0-0) (0,0-0) (0,0-0) (0,0-0) |
| (0,0-0) (0,0-0) (0,0-0) (0,0-0) (0,0-0) (0,0-0) (0,0-0) (0,0-0) (0,0-0) (0,0-0) (0,0-0) (0,0-0) (0,0-0) (0,0-0) (0,0-0) (0,0-0) (0,0-0) (0,0-0) (0,0-0) (0,0-0) (0,0-0) (0,0-0) (0,0-0) (0,0-0) (0,0-0) (0,0-0) (0,0-0) (0,0-0) (0,0-0) (0,0-0) |
| (0,0-0) (0,0-0) (0,0-0) (0,0-0) (0,0-0) (0,0-0) (0,0-0) (0,0-0) (0,0-0) (0,0-0) (0,0-0) (0,0-0) (0,0-0) (0,0-0) (0,0-0) (0,0-0) (0,0-0) (0,0-0) (0,0-0) (0,0-0) (0,0-0) (0,0-0) (0,0-0) (0,0-0) (0,0-0) (0,0-0) (0,0-0) (0,0-0) (0,0-0) (0,0-0) |
| (0,0-0) (0,0-0) (0,0-0) (0,0-0) (0,0-0) (0,0-0) (0,0-0) (0,0-0) (0,0-0) (0,0-0) (0,0-0) (0,0-0) (0,0-0) (0,0-0) (0,0-0) (0,0-0) (0,0-0) (0,0-0) (0,0-0) (0,0-0) (0,0-0) (0,0-0) (0,0-0) (0,0-0) (0,0-0) (0,0-0) (0,0-0) (0,0-0) (0,0-0) (0,0-0) |
| (0,0-0) (0,0-0) (0,0-0) (0,0-0) (0,0-0) (0,0-0) (0,0-0) (0,0-0) (0,0-0) (0,0-0) (0,0-0) (0,0-0) (0,0-0) (0,0-0) (0,0-0) (0,0-0) (0,0-0) (0,0-0) (0,0-0) (0,0-0) (0,0-0) (0,0-0) (0,0-0) (0,0-0) (0,0-0) (0,0-0) (0,0-0) (0,0-0) (0,0-0) (0,0-0) |
| (0,0-0) (0,0-0) (0,0-0) (0,0-0) (0,0-0) (0,0-0) (0,0-0) (0,0-0) (0,0-0) (0,0-0) (0,0-0) (0,0-0) (0,0-0) (0,0-0) (0,0-0) (0,0-0) (0,0-0) (0,0-0) (0,0-0) (0,0-0) (0,0-0) (0,0-0) (0,0-0) (0,0-0) (0,0-0) (0,0-0) (0,0-0) (0,0-0) (0,0-0) (0,0-0) |
[/H1]
[H2]
| (0,0-0) (0,0-0) (0,0-0) (0,0-0) (0,0-0) (0,0-0) (0,0-0) (0,0-0) (0,0-0) (0,0-0) (0,0-0) (0,0-0) (0,0-0) (0,0-0) (0,0-0) (0,0-0) (0,0-0) (0,0-0) (0,0-0) (0,0-0) (0,0-0) (0,0-0) (0,0-0) (0,0-0) (0,0-0) (0,0-0) (0,0-0) (0,0-0) (0,0-0) (0,0-0) |
| (0,0-0) (0,0-0) (0,0-0) (0,0-0) (0,0-0) (0,0-0) (0,0-0) (0,0-0) (0,0-0) (0,0-0) (0,0-0) (0,0-0) (0,0-0) (0,0-0) (0,0-0) (0,0-0) (0,0-0) (0,0-0) (0,0-0) (0,0-0) (0,0-0) (0,0-0) (0,0-0) (0,0-0) (0,0-0) (0,0-0) (0,0-0) (0,0-0) (0,0-0) (0,0-0) |
| (0,0-0) (0,0-0) (0,0-0) (0,0-0) (0,0-0) (0,0-0) (0,0-0) (0,0-0) (0,0-0) (0,0-0) (0,0-0) (0,0-0) (0,0-0) (0,0-0) (0,0-0) (0,0-0) (0,0-0) (0,0-0) (0,0-0) (0,0-0) (0,0-0) (0,0-0) (0,0-0) (0,0-0) (0,0-0) (0,0-0) (0,0-0) (0,0-0) (0,0-0) (0,0-0) |
| (0,0-0) (0,0-0) (0,0-0) (0,0-0) (0,0-0) (0,0-0) (0,0-0) (0,0-0) (0,0-0) (0,0-0) (0,0-0) (0,0-0) (0,0-0) (0,0-0) (0,0-0) (0,0-0) (0,0-0) (0,0-0) (0,0-0) (0,0-0) (0,0-0) (0,0-0) (0,0-0) (0,0-0) (0,0-0) (0,0-0) (0,0-0) (0,0-0) (0,0-0) (0,0-0) |
| (0,0-0) (0,0-0) (0,0-0) (0,0-0) (0,0-0) (0,0-0) (0,0-0) (0,0-0) (0,0-0) (0,0-0) (0,0-0) (0,0-0) (0,0-0) (0,0-0) (0,0-0) (0,0-0) (0,0-0) (0,0-0) (0,0-0) (0,0-0) (0,0-0) (0,0-0) (0,0-0) (0,0-0) (0,0-0) (0,0-0) (0,0-0) (0,0-0) (0,0-0) (0,0-0) |
| (0,0-0) (0,0-0) (0,0-0) (0,0-0) (0,0-0) (0,0-0) (0,0-0) (0,0-0) (0,0-0) (0,0-0) (0,0-0) (0,0-0) (0,0-0) (0,0-0) (0,0-0) (0,0-0) (0,0-0) (0,0-0) (0,0-0) (0,0-0) (0,0-0) (0,0-0) (0,0-0) (0,0-0) (0,0-0) (0,0-0) (0,0-0) (0,0-0) (0,0-0) (0,0-0) |
| (0,0-0) (0,0-0) (0,0-0) (0,0-0) (0,0-0) (0,0-0) (0,0-0) (0,0-0) (0,0-0) (0,0-0) (0,0-0) (0,0-0) (0,0-0) (0,0-0) (0,0-0) (0,0-0) (0,0-0) (0,0-0) (0,0-0) (0,0-0) (0,0-0) (0,0-0) (0,0-0) (0,0-0) (0,0-0) (0,0-0) (0,0-0) (0,0-0) (0,0-0) (0,0-0) |
| (0,0-0) (0,0-0) (0,0-0) (0,0-0) (0,0-0) (0,0-0) (0,0-0) (0,0-0) (0,0-0) (0,0-0) (0,0-0) (0,0-0) (0,0-0) (0,0-0) (0,0-0) (0,0-0) (0,0-0) (0,0-0) (0,0-0) (0,0-0) (0,0-0) (0,0-0) (0,0-0) (0,0-0) (0,0-0) (0,0-0) (0,0-0) (0,0-0) (0,0-0) (0,0-0) |
| (0,0-0) (0,0-0) (0,0-0) (0,0-0) (0,0-0) (0,0-0) (0,0-0) (0,0-0) (0,0-0) (0,0-0) (0,0-0) (0,0-0) (0,0-0) (0,0-0) (0,0-0) (0,0-0) (0,0-0) (0,0-0) (0,0-0) (0,0-0) (0,0-0) (0,0-0) (0,0-0) (0,0-0) (0,0-0) (0,0-0) (0,0-0) (0,0-0) (0,0-0) (0,0-0) |
| (0,0-0) (0,0-0) (0,0-0) (0,0-0) (0,0-0) (0,0-0) (0,0-0) (0,0-0) (0,0-0) (0,0-0) (0,0-0) (0,0-0) (0,0-0) (0,0-0) (0,0-0) (0,0-0) (0,0-0) (0,0-0) (0,0-0) (0,0-0) (0,0-0) (0,0-0) (0,0-0) (0,0-0) (0,0-0) (0,0-0) (0,0-0) (0,0-0) (0,0-0) (0,0-0) |
| (0,0-0) (0,0-0) (0,0-0) (0,0-0) (0,0-0) (0,0-0) (0,0-0) (0,0-0) (0,0-0) (0,0-0) (0,0-0) (0,0-0) (0,0-0) (0,0-0) (0,0-0) (0,0-0) (0,0-0) (0,0-0) (0,0-0) (0,0-0) (0,0-0) (0,0-0) (0,0-0) (0,0-0) (0,0-0) (0,0-0) (0,0-0) (0,0-0) (0,0-0) (0,0-0) |
| (0,0-0) (0,0-0) (0,0-0) (0,0-0) (0,0-0) (0,0-0) (0,0-0) (0,0-0) (0,0-0) (0,0-0) (0,0-0) (0,0-0) (0,0-0) (0,0-0) (0,0-0) (0,0-0) (0,0-0) (0,0-0) (0,0-0) (0,0-0) (0,0-0) (0,0-0) (0,0-0) (0,0-0) (0,0-0) (0,0-0) (0,0-0) (0,0-0) (0,0-0) (0,0-0) |
| (0,0-0) (0,0-0) (0,0-0) (0,0-0) (0,0-0) (0,0-0) (0,0-0) (0,0-0) (0,0-0) (0,0-0) (0,0-0) (0,0-0) (0,0-0) (0,0-0) (0,0-0) (0,0-0) (0,0-0) (0,0-0) (0,0-0) (0,0-0) (0,0-0) (0,0-0) (0,0-0) (0,0-0) (0,0-0) (0,0-0) (0,0-0) (0,0-0) (0,0-0) (0,0-0) |
| (0,0-0) (0,0-0) (0,0-0) (0,0-0) (0,0-0) (0,0-0) (0,0-0) (0,0-0) (0,0-0) (0,0-0) (0,0-0) (0,0-0) (0,0-0) (0,0-0) (0,0-0) (0,0-0) (0,0-0) (0,0-0) (0,0-0) (0,0-0) (0,0-0) (0,0-0) (0,0-0) (0,0-0) (0,0-0) (0,0-0) (0,0-0) (0,0-0) (0,0-0) (0,0-0) |
| (0,0-0) (0,0-0) (0,0-0) (0,0-0) (0,0-0) (0,0-0) (0,0-0) (0,0-0) (0,0-0) (0,0-0) (0,0-0) (0,0-0) (0,0-0) (0,0-0) (0,0-0) (0,0-0) (0,0-0) (0,0-0) (0,0-0) (0,0-0) (0,0-0) (0,0-0) (0,0-0) (0,0-0) (0,0-0) (0,0-0) (0,0-0) (0,0-0) (0,0-0) (0,0-0) |
| (0,0-0) (0,0-0) (0,0-0) (0,0-0) (0,0-0) (0,0-0) (0,0-0) (0,0-0) (0,0-0) (0,0-0) (0,0-0) (0,0-0) (0,0-0) (0,0-0) (0,0-0) (0,0-0) (0,0-0) (0,0-0) (0,0-0) (0,0-0) (0,0-0) (0,0-0) (0,0-0) (0,0-0) (0,0-0) (0,0-0) (0,0-0) (0,0-0) (0,0-0) (0,0-0) |
| (0,0-0) (0,0-0) (0,0-0) (0,0-0) (0,0-0) (0,0-0) (0,0-0) (0,0-0) (0,0-0) (0,0-0) (0,0-0) (0,0-0) (0,0-0) (0,0-0) (0,0-0) (0,0-0) (0,0-0) (0,0-0) (0,0-0) (0,0-0) (0,0-0) (0,0-0) (0,0-0) (0,0-0) (0,0-0) (0,0-0) (0,0-0) (0,0-0) (0,0-0) (0,0-0) |
| (0,0-0) (0,0-0) (0,0-0) (0,0-0) (0,0-0) (0,0-0) (0,0-0) (0,0-0) (0,0-0) (0,0-0) (0,0-0) (0,0-0) (0,0-0) (0,0-0) (0,0-0) (0,0-0) (0,0-0) (0,0-0) (0,0-0) (0,0-0) (0,0-0) (0,0-0) (0,0-0) (0,0-0) (0,0-0) (0,0-0) (0,0-0) (0,0-0) (0,0-0) (0,0-0) |
| (0,0-0) (0,0-0) (0,0-0) (0,0-0) (0,0-0) (0,0-0) (0,0-0) (0,0-0) (0,0-0) (0,0-0) (0,0-0) (0,0-0) (0,0-0) (0,0-0) (0,0-0) (0,0-0) (0,0-0) (0,0-0) (0,0-0) (0,0-0) (0,0-0) (0,0-0) (0,0-0) (0,0-0) (0,0-0) (0,0-0) (0,0-0) (0,0-0) (0,0-0) (0,0-0) |
| (0,0-0) (0,0-0) (0,0-0) (0,0-0) (0,0-0) (0,0-0) (0,0-0) (0,0-0) (0,0-0) (0,0-0) (0,0-0) (0,0-0) (0,0-0) (0,0-0) (0,0-0) (0,0-0) (0,0-0) (0,0-0) (0,0-0) (0,0-0) (0,0-0) (0,0-0) (0,0-0) (0,0-0) (0,0-0) (0,0-0) (0,0-0) (0,0-0) (0,0-0) (0,0-0) |
| (0,0-0) (0,0-0) (0,0-0) (0,0-0) (0,0-0) (0,0-0) (0,0-0) (0,0-0) (0,0-0) (0,0-0) (0,0-0) (0,0-0) (0,0-0) (0,0-0) (0,0-0) (0,0-0) (0,0-0) (0,0-0) (0,0-0) (0,0-0) (0,0-0) (0,0-0) (0,0-0) (0,0-0) (0,0-0) (0,0-0) (0,0-0) (0,0-0) (0,0-0) (0,0-0) |
| (0,0-0) (0,0-0) (0,0-0) (0,0-0) (0,0-0) (0,0-0) (0,0-0) (0,0-0) (0,0-0) (0,0-0) (0,0-0) (0,0-0) (0,0-0) (0,0-0) (0,0-0) (0,0-0) (0,0-0) (0,0-0) (0,0-0) (0,0-0) (0,0-0) (0,0-0) (0,0-0) (0,0-0) (0,0-0) (0,0-0) (0,0-0) (0,0-0) (0,0-0) (0,0-0) |
| (0,0-0) (0,0-0) (0,0-0) (0,0-0) (0,0-0) (0,0-0) (0,0-0) (0,0-0) (0,0-0) (0,0-0) (0,0-0) (0,0-0) (0,0-0) (0,0-0) (0,0-0) (0,0-0) (0,0-0) (0,0-0) (0,0-0) (0,0-0) (0,0-0) (0,0-0) (0,0-0) (0,0-0) (0,0-0) (0,0-0) (0,0-0) (0,0-0) (0,0-0) (0,0-0) |
| (0,0-0) (0,0-0) (0,0-0) (0,0-0) (0,0-0) (0,0-0) (0,0-0) (0,0-0) (0,0-0) (0,0-0) (0,0-0) (0,0-0) (0,0-0) (0,0-0) (0,0-0) (0,0-0) (0,0-0) (0,0-0) (0,0-0) (0,0-0) (0,0-0) (0,0-0) (0,0-0) (0,0-0) (0,0-0) (0,0-0) (0,0-0) (0,0-0) (0,0-0) (0,0-0) |
| (0,0-0) (0,0-0) (0,0-0) (0,0-0) (0,0-0) (0,0-0) (0,0-0) (0,0-0) (0,0-0) (0,0-0) (0,0-0) (0,0-0) (0,0-0) (0,0-0) (0,0-0) (0,0-0) (0,0-0) (0,0-0) (0,0-0) (0,0-0) (0,0-0) (0,0-0) (0,0-0) (0,0-0) (0,0-0) (0,0-0) (0,0-0) (0,0-0) (0,0-0) (0,0-0) |
| (0,0-0) (0,0-0) (0,0-0) (0,0-0) (0,0-0) (0,0-0) (0,0-0) (0,0-0) (0,0-0) (0,0-0) (0,0-0) (0,0-0) (0,0-0) (0,0-0) (0,0-0) (0,0-0) (0,0-0) (0,0-0) (0,0-0) (0,0-0) (0,0-0) (0,0-0) (0,0-0) (0,0-0) (0,0-0) (0,0-0) (0,0-0) (0,0-0) (0,0-0) (0,0-0) |
| (0,0-0) (0,0-0) (0,0-0) (0,0-0) (0,0-0) (0,0-0) (0,0-0) (0,0-0) (0,0-0) (0,0-0) (0,0-0) (0,0-0) (0,0-0) (0,0-0) (0,0-0) (0,0-0) (0,0-0) (0,0-0) (0,0-0) (0,0-0) (0,0-0) (0,0-0) (0,0-0) (0,0-0) (0,0-0) (0,0-0) (0,0-0) (0,0-0) (0,0-0) (0,0-0) |
| (0,0-0) (0,0-0) (0,0-0) (0,0-0) (0,0-0) (0,0-0) (0,0-0) (0,0-0) (0,0-0) (0,0-0) (0,0-0) (0,0-0) (0,0-0) (0,0-0) (0,0-0) (0,0-0) (0,0-0) (0,0-0) (0,0-0) (0,0-0) (0,0-0) (0,0-0) (0,0-0) (0,0-0) (0,0-0) (0,0-0) (0,0-0) (0,0-0) (0,0-0) (0,0-0) |
| (0,0-0) (0,0-0) (0,0-0) (0,0-0) (0,0-0) (0,0-0) (0,0-0) (0,0-0) (0,0-0) (0,0-0) (0,0-0) (0,0-0) (0,0-0) (0,0-0) (0,0-0) (0,0-0) (0,0-0) (0,0-0) (0,0-0) (0,0-0) (0,0-0) (0,0-0) (0,0-0) (0,0-0) (0,0-0) (0,0-0) (0,0-0) (0,0-0) (0,0-0) (0,0-0) |
| (0,0-0) (0,0-0) (0,0-0) (0,0-0) (0,0-0) (0,0-0) (0,0-0) (0,0-0) (0,0-0) (0,0-0) (0,0-0) (0,0-0) (0,0-0) (0,0-0) (0,0-0) (0,0-0) (0,0-0) (0,0-0) (0,0-0) (0,0-0) (0,0-0) (0,0-0) (0,0-0) (0,0-0) (0,0-0) (0,0-0) (0,0-0) (0,0-0) (0,0-0) (0,0-0) |
[/H2]
[/Map]

[Entities]
[/Entities]
